âm - minus
ảm đạm - sombre, gloomy
âm lịch - lunar calendar
âm thanh - sound (e.g. in film)
âm u - gloomy
ẩn - to hide
ăn đòn - to receive strokes; to get a thrashing; to get spanked
ăn kiêng - to go on a diet
ăn mặn - to eat meat
ăn mừng - to celebrate
ấn phẩm - publication
ăn thoả thích - eat as much as you like (to your hearts content)
an toàn - safe
ảnh hưởng - to influence
anh/chị/em họ - cousin
áo đầm - dress
áo sơ mi - collared shirt
áo thun giãn - relaxing t-shirt
ào vest - suit
áp lực - pressure
bài kiểm tra - test, quiz
bài tây - playing cards
bài toán - math problem
ban công - balcony
bán đất - land for sale
ban đêm - night time
ban ngày - day time
bàn phím - keyboard
bàn tán - chatter, whisper (group)
bản thân - oneself (same as mình)
bán thời gian - part time
bang - state
bang - state (like Maine)
bằng lái xe - driver's license
báo cáo - report, to report
báo cáo - to report, report
bao cao su - condom
bảo hiểm - insurance
bảo vệ - to protect
bắp cải - cabbage
bật - turn on
bắt cá hai tay - Grab fish with both hands
bắt chước - to imitate
bất kì - any
bắt tay - to shake hands, to join hands with, to start
bể - to break
bển - that side (like ẻm, ảnh)
béo phì - obesity
bí ẩn - mystery
bị lạc đường - to get lost
bí mật - secret
bi quan - pessimistic
bí quyết - secret (for success); knack
bị rụng - to shed, lose
bị sét đánh - struck by lightning
biến thành - to turn into (magic)
biến ý tưởng thành hiện thực - to make an idea real
Biết bao - so much, how much
biết đâu - who knows
biểu tượng - symbol, icon (computer)
bình đẳng giới - gender equality
bình tĩnh - calm, to calm down
bình tĩnh - to be calm
bít cửa - to lock or close a door (figurative)
bộ - set
bồ (người yêu) - boyfriend, girlfriend (colloquial)
bổ ích - useful
bó tay - to give up
bộ y tế - Ministry of Health
bối cảnh - circumstances (Synonym: hoàn cảnh)
bóng bàn - table tennis
bong bóng - balloon
bóng chày - baseball
bóng chày - baseball
bóng rổ - basketball
bự - big
bữa nay - today
bức - Classifier for letters/pictures/photo
bực mình - annoyed, annoying
buôn bán - to trade/deal in, to do businees in
buồn cười, mắc cười - funny, finding something funny
buông - to release, let go
buông tay - to release from one's hand
cà chua - tomato
cà giựt - to shake, jerk ones body
cá nhân - individual, personal
cà pháo - vietnamese eggplant
cà tím - eggplant
cà vạt - necktie
các vùng ven biển - coastal areas
cách ly xã hội - social distancing
cách xưng hô (em, anh) - way of addressing
cái bảng - sign
cái hũ - jar
cái mẹo - a tip, trick
cãi nhau - to argue
cái nôi - crib
cái son - lipstick
cái thắng - brakes
cải thiện - to improve
cải thiện - to improve
cảm giác - feeling
cảm kích - to appreciate
cảm nhận - to sense, feel
căn cứ vào - to base on
cân nhắc - to consider
cần thiết - necessary
căng thẳng - stress
căng thẳng - stressed
cảnh - scene (film)
cảnh quan - landscape
Cạo râu - to shave (beard)
cao su - rubber
cặp đôi - a couple (two people)
cập nhật - to update
cất - to put away
câu lạc bộ - club
cầu lông - badminton
cầu vượt - overpass
chấm - to dip
chạm - to touch
chậm chạp - slow
chăm chỉ - hard, industrious
chăm sóc - to care for
chăm sóc - to take care of, attend to
chặn đường - to block/stop someone on the road
chân thành - sincere
chẳng lẽ - could it be possible that...?
chát - acrid
chất dẻo - flexible material
chất liệu - material (e.g. cotton)
chảy - flow, melt
chạy nhảy - busy, jumping around
chế độ ăn - diet (eg vegetarian)
chênh lệch - gap, difference
chi nhánh - branch, franchise
chi tiết - detail
chi tiêu - to spend (money)
chia tay - to break up
chiến tranh - war
chính hãng - genuine
chính hãng - genuine
chinh phục - to conquer, to win over somebody
chính tả - spelling
chịu - to agree
chịu - to withstand/tolerate
chó sủa là chó không cắn - the dog the barks the loudest doesn't bite
cho thấy - to show
choáng - shock
chợt - suddenly
chứ bộ - rather
chu đáo - thoughtful, considerate
chú rể - groom
chủ yếu - essential, main, primary chief
chữa - to cure; to heal
chúc bạn ăn ngon miệng - enjoy your meal
chúc mẹ tròn con vuông - happy new baby
chức vụ - duty, power, responsibility
chừng - about, approximately
chúng - plural (persons)
chứng chỉ - certificate
chứng minh - to prove
chứng minh thư - ID card
Chung sống - to live with, cope
chủng tộc - race (people)
chuyên ngành - specialty, professional knowledge, university major
chuyên nghiệp - professional
chuyên nghiệp - professional (manner)
cổ - old, ancient
cơ bản - basic, fundamental
có bầu, có thai - to be pregnant
cô dâu - bride
cơ hội - an opportunity, chance
có ích - helpful; useful
có khi - sometimes
Có mới nới cũ - New one in, old one out
có qua có lại - Give and you shall receive
cố ý làm - to do something on purpose
con một - only child
còn nguyên - intact
con thỏ - rabbit
con vật - animal
công bằng - fair
công nhận - to recognize; to accept
công sức - effort
công việc - job (career/business)
cứ - to keep on (doing)
cứ - to keep on (doing), to just
cứ 10 người thì... - for every 10 people...
Cứ chọn đại một cái đi! - just choose one randomly!
cụ thể - specific
cụ thể - specific, concrete
cua - to take out a girl (slang)
cực khổ - miserable
cực kỳ - extremely
cùi bắp - bad, lousy (slang)
cùn - to be blunt (e.g. knife)
cúng - to pray, make an offering
cung cấp - to supply, provide
cung cấp - to supply, provide
cũng như - as well as
cũng tùy - it depends
cuộc nói chuyện - conversation
cười - to smile
cưỡi lạc đà - ride a camel
cuốn hút - to fascinate
đã - satisfied, pleasurable, cool (e.g. cái này đã lắm nè!)
đá banh - soccer
đa dạng - diversity
đa dạng - variety
đa số - majority
đặc trưng - typical, speciality
đại khái - in general
đảm bảo - to guarantee
đảm bảo - to guarantee, ensure
đảm nhận - to assume responsibility of something
dán - stick
dân cư - population (of a place)
dần dần - gradually; little by little
dặn dò - to advise, instruct something ahead of time
dân số - population
đắng - bitter (ingredient)
đáng - worth it
đàng hoàng - dignified, proper, nice
Đáng yêu - adorable
dành - to save/reserve
đánh vần - to spell
dao - knife
đào giếng - dig a well
đắp - to cover something with a layer
đập - to thrash, swat, strike
đặt - to put, reserve
đặt cọc - to deposit
đặt món - order in advance
đất nước - country
dầu mỡ - oily, greasy
đầy đủ - full
đẻ - to give birth
để dành cho lần tiếp theo - leave for next time
dễ điên chưa? - are you crazy?
đề nghị - to propose, to suggest
dễ nhìn - good-looking
dễ như ăn kẹo - easy as pie
đề xuất - to propose, put forward, suggest
đề xuất - to propose, to put forward
đếm - to count
đếm - to count
đến lượt - wait your turn
dẻo - flexible
đẹp lão - to age gracefully
dĩ nhiên - of course
dĩ nhiên - of course
đi phượt - travel by motorbike
đi theo bờ biển - follow the coast
dị ứng - allergy, to be allergic
dịch vụ - service
dịch vụ - service
điện nước đầy đủ - sexy
diễn sâu - fake posing
diễn tả - to express
điện thoại đổ chuông - the phone rings
diện tích - area
diện tích - surface area, area (geometry)
điền vào chỗ trống - fill in the blanks
diễn viên - actor
điều kiện - condition, requirement
dịp - occasion, chance
độ - degree (Celsius or Fahrenheit)
đổ - pour, spill
đồ cổ - antique
đồ nội thất - furniture
đoạn đường - section (of road)
đoán mò - to make a wild guess
độc đắc - jackpot
độc nhất - unique
dời - to move, transfer, shift, reschedule
đòi - to take back, to ask (strong)
đói cồn cào - really hungry
đối diện - opposite, across from (place)
đôi lúc - sometimes
đối phương - the opposite party; the opposite side; the enemy
đổi thành - change into
đối tượng - (sciences) a subject, usually a human one, to study or experiment on
đối xử - to treat
đổi ý - to change one's mind
đón - celebrate; welcome
dọn ra - come out
động cơ - engine, motive
động cơ - motivation, engine
đóng phim - to act in a movie
động viên - to encourage
đột nhiên - suddenly
dư - extra, leftover (opposite thiếu)
dữ - really, so, very
dự báo thời tiết - weather forecast
dự định - to intend; to plan
dự đoán - to predict
dù sao thì - anyway
đua - race
đưa - to give
đưa - to hand something, to pass
dựa - to lean
dựa - to lean on, stand against
đứa con - child, offspring
đua đòi - to imitate, to copy someone
đựng - to hold, contain
đựng - to hold, contain
đứng lên - to stand up
đứng tên - to put down ones name, cosign
đuôi - tail
dưới cùng - the bottom (limit)
dượng - uncle in law, stepfather
dương lịch - western calendar
đương nhiên - of course
duyên - tact, charm, grace
êm - soft, calm
Em đỡ chưa? - did you get better?
ép - to force, pressure sbdy to do something
gãi - to scratch
ganh tị - jealous (envy)
ghê - really (extremely)
ghê - terrible, disgusting, scary, horrifying
ghé - to drop by
ghen - jealous (love)
ghép - to joint, to connect
ghi - to write
ghiền - to be addicted to something
gia hạn - to extend, renew
gia sư - tutor
giảm cân - to lose weight
giãn ra - to stretch out
giận, tức giận - to be angry, furious
Giáng sinh / Noel - Christmas
giành - to dispute, compete with something
giao hàng - to deliver
giáo sư - a professor
giao tiếp - communication (to communicate)
giáp - to border with
giấu - to hide something
giấy dán tường - wallpaper
giấy khám sức khỏe - health certificate, health report
giấy tờ - document/form/papers
giấy tờ - document/form/papers
giỗ - death anniversary
giơ - raise
gió thổi - the wind blows
giới thiệu - to introduce
giới thiệu - to recommend
giới tính - gender
giọng - voice
giọng địa phương - regional accent
gõ - to type on a keyboard
gom - to gather
gọn - neat, tidy (way of speaking)
gọn gàng - neat
gọn nhẹ - compact
góp ý - to contribute comments
góp ý - to suggest, contribute the idea
gu - taste, preferences
hại - to harm (hút thuốc có ... cho sức khoẻ)
hài hoà - harmonious
hài lòng - to be satisfied
hài lòng - to be satisfied
hạn chế - to limit, restrict
Hán Việt - Sino-Vietnamese
hãng - company, brand
hàng - row, line, section
hàng xóm - neighbor
hành lý - luggage
hành vi - behavior, action
hảo - to like a food
hào hứng - excited
hào hứng - excited
hảo ngọt - to have a sweet tooth
hấp dẫn - tempting
hạt - seed, nut
hạt điều - cashew
hầu hết - almost all
hẹn - appointment
hiếm - rare
hiện đại - modern
hiện tại - currently
hiện tại - present, currently
hiệu quả - efective, effect
hiệu quả - effective
hình chữ nhật - rectangle
hình dung - outer appearance
hình tròn - circle
hình vuông - square
hoài - ceaselessly, always
hoài - constantly
hoãn - to delay, postpone
hoàn cảnh - circumstances (of someone)
hoàn hảo - perfect
hoàn toàn - totally, entirely
hoạt động - activity, event
học được - to have learned something
học hỏi - to learn
hội - an association (group)
hôi - smelly
hôi - smelly
hối - to urge someone to do something
hồi hộp - nervous (butterflies)
hồi nãy - just now, a moment ago
hồi xưa, ngày xưa - old days
họng - throat
hợp - suitable
hợp lý - sensible, sound, reasonable
hứa - to promise
huấn luyện viên - coach
in - to print something
kaizen - concept
kệ - whatever, screw it, what the hell
kẻ thù - enemy
kéo dài - to last
kéo lên, xuống - to scroll up/down
kết - to be keen on / have a crush on someone
kết quả - result, outcome
khá - quite
khả năng - ability, capability
khả năng - ability, possibility
khách hàng - customer
khẳng định - to confirm
khắp nơi - everywhere
khát - thirsty
khát khó cổ - really thirsty
khát nước - thirsty
khẩu trang - face mask
khéo - to be skillful
khiến - to cause, to make (someone do something)
khiêng - carry
khó chịu - unpleasant, annoying
khoa học máy tính - computer science
khoái - to enjoy, to like (= thích)
khoe - to brag, show off, boast
khỏi - not necessary
khối lượng - mass
khỏi thối - keep the change
không chịu làm - don't feel like doing
không còn đầu óc để - to not feel like doing something
không gian - space, atmosphere
không khí - air
không lẽ học suốt đời - it doesn't make sense to study your whole life
khúc - piece, section, chunk (e.g. of road)
khùng - crazy, mad, idiot
khuyên - to advise, recommend
khuyết điểm - đíavantage, weak point
kích thước - size, dimensions
kiểm tra - to test, examine
kiên nhẫn - patient
kiên nhẫn - patient
kiến thức - knowledge
kiểu - style
kinh nghiệm - experience
kỳ cục - weird, strange, odd
kỷ niệm - memory
ký tên - to sign one's name
là chính mình - "be yourself"
lạc hậu - outdated, backward
lạc quan - optimistic
làm anh hết hồn - ah! you scared me...
lâm râm - light rain
làm riết quen - done something a million times
làm sao hay vậy - how do you do that?
làm tự do - freelance
làm từ thiện - charity
lần lượt - one after another
lãng mạn - romantic
lãng mạn - romantic
lãng phí - to waste
lành - heal
lành mạnh - healthy
lãnh sự quán - embassy
lạnh sun vòi - really cold (shrinks penus)
lắp ghép - to put together; to assemble
lập trình - program
lập tức - immediately
lát - moment
lây - to be contagious
lấy độc trị độc - fight fire with fire
lẹ - hurry up, fast
liếm - to lick
liên quan đến - concerned [with]; related [to]
linh động - flexible (time)
lỗ - hole
loài - kind, species
loài - kind, species
loạt - bunch, series
lời khuyên - advice
lông - feather, fur, body hair
lộng lẫy - gorgeous, magnificent, splendid
lừa - to dupe, trick, cheat
lựa cơm mà gắp mắm - lemons
lượng - amount
lương - salary
lưu loát - fluent
lưu ý - careful, watch out, pay attention
mà đáo thành công - horses bring success
ma tuý - drugs, narcotics
mắc cười - funny
mắc ói - vomit
mắc tè - have to pee
mãi mãi - forever
mai mốt - future
mai mốt - in the future (sau này)
màn hình - screen
mang dép - wear flipflops
mạng xã hội - social network
mất công - complicated (too many steps)
mất công - to waste time doing something
mất dạy - (vulgar) Ill-bred, unmannerly, not classy
mặt mũi - a persons look/countenance
mặt trăng - moon
mặt trời - sun
mặt trời lặn - sunset
mặt trời mọc - sunrise
màu sắc - color
may mà - lucky that
mày ngu vãi lồn - you're ****ing stupid
máy xay - grinder, blender
mê - to be fond of, keen on
mệt mỏi - tired
mếu máo - to whine
miếng dán màn hình - screen wallpaper
miêu tả - to describe
mỉm cười - a small smile
mình đi nào - let's go!
mổ - to operate
mồ hôi - sweat
mồ hôi - sweat
mỡ trong máu - cholesterol
mơ ước - dream, hope
mộc - plain, natural (material)
mọc - to grow (plants, hair), to rise (sun)
mỏi - to be fatigued
môi trường - environment
môi trường - environment
môn - subject
mòn - worn out (shoes, wallet)
món tráng miệng - dessert
Một hôm - one day
một mẻ bánh pudding - a batch of pudding
một mũi tên trúng hai con nhạn - kill two birds with one stone
một trong những - one of the...
mù màu - color blind
mưa bụi - misting rain
mùa thu - autumn
mục - section, item on a menu
mục đích - goal, purpose
mức độ - level
mừng - to celebrate
nắm - to hold; to grip; to grasp
Nắm tay - to hold hands
năng động - dynamic, active
nảy ra một ý - to come across the mind
nảy ra, nghĩ ra - to come up with
nét (x có hai nét) - line, mark
ngạc nhiên - to be surprised
ngại - to feel reluctant
ngại - to hesitate
ngán - sick of something (food)
ngang qua - across
ngành - major
ngập - flood
ngập - to flood
ngắt - to interrupt
ngắt câu - break up a sentence
ngẫu hứng - last minute (person)
ngày kỷ niệm - anniversary
ngây thơ - naive, innocent
nghe lời đi - listen to me
nghe máy, bắt máy - answer the phone
nghĩ bụng - to tell oneself
nghiêm trọng - serious
nghiêm trọng - serious
nghiêm trọng - serious; grave; critical
nghiêng - lean
ngộ - curious, queer, interesting
ngõ cụt - (noun) DEAD END, cul-de-sac; blind alley
ngoài cùng - outer edge limit
ngoài đời - real life
ngoại ngữ - foreign language
ngoại trừ - except
ngoan - good, well-behaved
ngồi - to sit
ngôi làng - village
ngon, nuột, mướt - sexy (girl)
ngủ nướng - sleep late
ngứa ngáy - itchy
ngừng lại - to stop
ngược lại - on the contrary
người dân - people
người dân tộc - ethnic minorities
người dân tộc - ethnic minorities
người địa phương - local people
người lao công - workers (like street sweepers)
nguy cơ - risk, danger
nguy hiểm - dangerous
nguyên chất - pure
nguyên liệu - ingredients
nhà nước, chính phủ - government
nhà quê - countryside (can be used to insult someone)
nhà tù - prison, jail
nhắc - to remind
nhạc cụ - musical instrument
nhầm - to confuse
nhầm lẫn - to be wrong, mistaken
Nhắm mắt - close your eyes
nhẫn - bitey like cheese
nhẫn - bitter (overall flavor)
nhân dịp - on the occasion of
nhấn mạnh - to emphasize
nhận ra - to realize
nhân sự - human resources
nhắn tin - to send a message
nhân vật - character (film)
nhanh gấp hai lần - twice as fast
nhập - to enter, to join, to type on keyboard
nhập khẩu - to import
nhạt - bland, faded, tasteless
nhiệt tình - enthusiastic
nhiệt tình - enthusiastic
nhiễu - to damage; to pester, trouble
nhìn kĩ - look carefully
nhờ - ask a favor
nhờ - thanks to
nho nhỏ - tiny
nhờ vs. nhỉ - nhờ only in north?
nhóm - group
nhốt - to confine, lock in/out
nhu cầu - (noun) a need/demand
như mọi khi - like usual
như thường lệ - as usual
nhuộm - to dye, color
nhường nào, dường nào - how much, to what extent
niềm vui - joy
no căng bụng - so full that your stomach is stretched out
nó không cần thiết - it's not necessary
nơi - place
nói bậy - to swear (bad words)
nội dung - content
nội qui - rules
nỗi sợ - fear
nội thất - interior
nổi tiếng khắp thế giới (khắp = all over/around) - famous all over the world
Nói trước, bước không qua - Don't speak too soon
nôn nóng - dying to do something (adj)
nóng chảy mỡ - really hot
nộp đơn - to turn in an application, to apply for (eg university)
nữ tính - feminine
núi lửa - volcano
nựng - pet
nước đến chân mới nhảy - to wait until the last minute
nước lọc - filtered water
nuôi - to bring up, to feed
nút - a button (machine, shirt)
nứt - crack, break (e.g bone)
Ổ cắm điện - electrical outlet
ô nhiễm - polluted
ợ nóng - heartburn
ớn - fed up
ồn ào - noisy
ồn ào - noisy
ổn định - stable
phạm pháp - illegal
phân biệt - to distinguish
phản đối - to oppose, disagree
phát hiện ra - to discover
phát hiện ra - to discover, find out
phát minh - to invent
phát triển - to develop
phẩu thuật thẩm mỹ - plastic surgery
phiền phức - annoying, complicated
phiền toái - inconvenient
phiếu - receipt, ballot, ticket, coupon
phim hài - comedy movie
phong cách - personal style
phỏng đoán - to guess
phòng đơn - single room
phòng khám bệnh - clinic
phù hợp - suitable, appropriate
phụ lão - elderly people (người già)
phức tạp - complicated
phục vụ - to serve
phương pháp - method
pizza và bia hợp với nhau - pizza and beer go well together
quá giang - to hitchhike, to cross a river
quá giờ - overtime
quá khứ - past
quá trình - process
quan điểm - point of view, perspective
quan tâm - to be interested in
quan tâm nhiều đến - care much about something
quan trọng - important
quầy - counter, booth
quấy rầy - to bother, pester
quậy, phá - naughty, noisy
quê - mortified, embarrassed
quốc tế - international
quốc tịch - nationality
quý giá - precious
quyền lợi - right, benefit
rắc rối - trouble, difficulty, problem
rách - torn
rằng - that (same as là)
rang - to roast
riêng - private, personal
rổ - basket
rối - confused, complicated
rơi - to fall; to drop
rốt cuộc - finally, in the end, after all
rút ra - to learn from
sản phẩm - product
sáng giờ - from morning to now
sang trọng - luxury
sát - close, closely
say nắng - to have a crush on somebody
say sưa - to be captivated; to be enthralled
sến - cheesy
siêng - diligent, carefully
sinh đôi - twins
sinh học - biology
sinh sống - to live/settle somewhere
sợ hãi - fear, scared
sở hữu - to possess
so sánh - to compare
sở thú - zoo
soạn - to prepare, compose (eg quần áo)
sốc - shocked
soi mói - check careful
sờn - worn out (clothes)
sống ảo - live virtual life
sống ảo - to live vainly in the virtual world
sự lựa chọn - choice, option
sửa - to check
sung sướng - happy, a deeper level than vui vẻ
sườn - ribs
sướng quá - good for you
suy - to ponder over; to think carefully
suy nghĩ - thinking
tách biệt - to separate, separate
tài chính - finance, financial
tài khoản - account (user)
tài nguyên thiên nhiên - natural resources
Tải xuống - to download
tấm - clothes, sheets, large flat objects (classifier)
tẩm bổ - to eat nourishing food
tâm huyết - commitment; devotion; dedication
tấm trải giường - bed sheet
tận tâm - dedicated
tăng - increase
tạnh mưa - stop raining
tạo điều kiện - to facilitate
tạp chí - magazine
tắt - turn off
tàu chìm - boat sinks
thả diều - to fly a kite
thắc mắc - to wonder, to be uneasy, to worry
thách thức - challenge
thai - fetus
thậm - very, quite
thậm chí - even
thậm chí - even
tham gia - to pảticipate, join, take part in
thân - close (dear), body
thân - dear (close)
than phiền - to complain
thắng - to win
thanh địa chỉ - address bar
thanh tìm kiếm - search bar
thật sự - really
thật thà - honest, truthful, sincere
thất vọng - disappointed
thất vọng - to be disappointed
thay phiên - to take turns
the - menthol flavor?
thể hiện - A indicates, shows, proves B
thể hiện - to express, display
thế là - so
thể thao - sports
thể tích - volume
thèm - to crave
theo chiều từ A đến B - from A to B
thi to - take an examination
thiệt tình mà nói thì... - "to tell the truth..."
thiếu - to lack
thơ - poetry
thợ may - tailor
thoáng - (1) fast, brief (2) open-minded
thối - give back money
thời hạn - term, period
thôi nôi - one year birthday celebration
thời trang - fashion
thồn - to stuff, cram
thông điệp - message (of a story)
thông thái - erudite, scholarly
thông thường - to be ordinary, common
thu nhập - income
thu phí - to charge a fee
thử thách - to challenge
thua - to lose
thức ăn qua chế biến - processed foods
thực hiện bởi ... với hỗ trợ - carried out by ... with support from
thức khuya - to stay up late
thực tế - reality
thùng - case, box
thưởng - reward
thường xuyên - often
thương, vết thương - injury
tỉ - billion
tỉ mỉ - meticulous
tích cực - positive
tiễn - to see someone off
tiến bộ - (of a person) progressing; making progress
tiến độ - speed, rate of progress
tiền lẻ - change
tiền mặt - cash
tiếng - sound
tiếp thu - to receive, to acquire
tiêu chuẩn - standard
tiêu cực - negative
tiểu đường - diabetes
tiêu hóa - digest
tin nhắn - text message
tin tưởng - to trust
tỉnh - province
tình cảm - sentiment, emotion, affection
tình cảm - sentiment, emotion, feeling
tình cờ - by chance
tính mạng - survival
tỉnh rượu - to get sober
tỉnh táo - awake and alert, well-rested
tổ chức - to organize
tò mò - curious
tổ tiên - ancestors
tỏ tình - to confess love
toán - mathematics
toàn - whole
toàn tâm toàn ý - with all of one's heart; completely dedicated
tốc độ - speed
tối - dark
tới tận đây - come all the way here
tóm tắt - to summarize
tồn - for something to be in surplus (because of weak sales)
tổn thương - to harm; to damage; to wound; to injure
tốn tiền - to waste money
tôn trọng - (verb) to respect; to honour; to revere
Tốt gỗ hơn tốt nước sơn - Beauty is on the inside
trả góp - to pay by installments
trách nhiệm - responsibility
trách nhiệm - responsibility
trại - camp
trải - to spread something on a surface (eg table cloth)
trải nghiệm - experience
trải nghiệm - to experience something
trái tim - heart (as in a set of emotions)
trận đấu - match, game
trang chủ - home page
trang điểm - make-up
trang phục - costume (film)
Tránh ra - get out of the way
trật - to miss (a target)
trau dồi - to improve; to develop; to cultivate
trên cùng - the top (end, limit)
trình bày - to present
trình độ - academic level
trò chơi - game
trợ lý - assistant
trở về - to return, to come back
trốn - to hide
trộn - to mix
tròn tròn - fat (polite)
trông chờ - to expect
trong lành - pure, fresh
Trong lòng X - Inside X's heart
trong thập kỷ qua... - in the past decade
trù phú - populous and rich
trực tiếp - direct, straight, live (TV)
trụng - to dip in hot water
trúng - to hit (a target)
trưng bày - to display, show
trúng số - to win a lottery
trước mắt - current and immediate times ahead
trước tiên - first of all
trường hợp - case, situation
tư - private
từ chối - to refuse
tự động - automatic
tự hào - to be proud of, pride
từ ngữ - compound word, expression
tù nhân - prisoner
tự tin - confident
từ từ - slowly
tức là - that is, that means
tụi nó - they (informal)
từng - each
từng người 1 - one by one
tuổi thọ trung bình - average lifespan
tương lai - future
tương tự - similar
tưởng tượng - to imagine
tuy nhiên - however
tuyệt - great, wonderful
ứng dụng - app
ủng hộ - to support, encourage
ưu điểm - strong point, advantage
ưu tiên - priority, to prioritize
uy tín - reputation, prestige
vá lại - to mend/sew back together
vãi - ****ing, extremely
vai trò - role
vấn đề - issue, problem
văn hoá phẩm - reading, audio or video entertainment material(s)
văng - bounce
vào ban đem - by night
vật - object
vị trí - position, location
vỉa hè - sidewalk
vô cùng - extremely
vỗ tay - to clap
vô ý - carless, randomly
vòi sen - shower
vội vã, vội vàng - to hurry
vốn từ - vocabulary
vu oan - to accuse unjustly
vừa người - fit
vùng - region, area
vượt biên - to cross the border illegally
vượt qua - to surpass, cross over
xà bông - soap
xa xôi - remote
xấu hổ - embarrassed
xây dựng - to build, construct
xảy ra - to occur, happen
xe cộ - vehicles
xe số - manual motorbike
xe tay ga - automatic motorbike
xếp - to fold
xếp hàng - to stand in line
xì-căng-đan - scandal
xi-nhan - blinker, signal (from French)
xì-tai - style
xì-trét - stress
xía vô - to interfere
xu - penny
xu hướng - trend
xử lý - to handle
xua đuổi - to drive something away (e.g. swat)
xuất khẩu - to export
xui - unlucky, unfortunate
xương - bone
y chang - just so, exactly
ý đồ - intention
y hệt, y chang - exactly the same
ý thức - awareness
ý tưởng - idea, thought
yên bình - peaceful
yên tâm - peace of mind
yên tĩnh - quiet
yên tĩnh - tranquil
yêu cầu - to require
yếu tố - key factor, element